QZKago Requiem	茄子卡狗	猫中毒	qzk	巧克力大战香子兰	黑猫打白猫	毒牛奶	嵯峨大战凯尔希
FFT	傅立叶快速变换	快速傅里叶变换	狒狒头	付费通	埃夫爱妇踢
木彫り鯰と右肩ゾンビ	木雕り鲶と右肩ゾンビ	僵尸	木雕鲇鱼	木雕鲶鱼	右肩僵尸
Mare Maris	船歌	大帆船	开船	小破船	海盗船	船医
ENERGY SYNERGY MATRIX	ESM	傻吊猫	沙雕猫
World Vanquisher	WV	世界征服者	世征	威猛先生	Mother Vanquisher
Schwarzschild	四川火娃	四川白娃	四川火娃弱智齿轮队
だんだん早くなる	渐渐加速	渐渐变快	蛋蛋变快	逐渐加快
ヒバナ	火花	匕八十	匕八卜	七八十	7810	瞄准fufu	狙击小日本
Kattobi KEIKYU Rider	卡透批来打	丁丁电车	列车	京急	京急电车	叮叮电车	叮叮车
人生リセットボタン	人生重置	人生reset button	remake	人生重启键	人生重置按钮	人生重置键
きたさいたま2000	塞他妈	北埼玉2000	kita	全网最帅五兄弟	过北脱新
セイクリッド　ルイン	太鼓达人	圣墟	圣灭	肾虚
Titania	泰坦尼亚	踢他娘	体坛	缇坦妮娅	阿迪快乐歌	江江比耶
ウミユリ海底譚	ウミユリ海底谭	海底捞	海百合海底谭	海脑瘫
Our Wrenally	OW	魔法阿嬷	魔法夏祭	守望先锋	高数
ヒビカセ	让其响彻	匕匕力也	比力也
My First Phone	小灵通	电话	手机
Blows Up Everything	吹爆	瞎几把吹
Excalibur ～Revived resolution～	生煎2	圣剑2	ex咖喱棒	福瑞2
Contrapasso -paradiso-	齿轮	天堂	ctps	天堂齿轮
CYBER Sparks	cs	魔理沙爆炸	魔光炮
Good Bye, Mr. Jack	再见杰哥	再见杰克
幸せになれる隠しコマンドがあるらしい	幸せになれる隐しコマンドがあるらしい	性瘾	幸隐	似乎有着能够变得幸福的隐藏指令	😄🔫
Ragnarok	黄昏	诸神黄昏
チルノのパーフェクトさんすう教室　⑨周年バージョン	9周年教室	笨蛋教室	九周年	baka	算术教室	⑨
GOODMEN	好男人	好人	良民
Oshama Scramble!	牛奶	哦杀妈	牛奶猫
最終鬼畜妹・一部声	最终鬼畜妹・一部声	蓝蓝路
コネクト	小圆op	联系	connect
砂の惑星 feat. HATSUNE MIKU	沙星	沙之行星	砂之惑星	砂星
Candy Tall Woman	糖果高女士	高血糖女人	糖高女	砍弟搞女人
ロキ	口丰	roki	口≠	ruaki
おちゃめ機能	おちゃめ机能	天真烂漫机能	五月病
弱虫モンブラン	弱虫	胆小鬼蒙布朗	换手练习歌
Maxi	马克西	马西	马戏
Garakuta Doll Play	GDP	鬼牌	小丑	果丹皮
Aiolos	艾欧洛斯	艾俄洛斯	A打头的风神
Magical Flavor	魔法味道	MF	milk+op
プナイプナイせんそう	噗奶噗奶	punai
"Little ""Sister"" Bitch"	婊子	小婊子	碧池
結ンデ開イテ羅刹ト骸	结ンデ开イテ罗刹ト骸	连起来又分开，罗刹与骨骸	结骸
MIRROR of MAGIC	MoM	镜魔	魔镜
MAXRAGE	绝赞交互	极怒	良怒2	满怒	红温
アージェントシンメトリー	argent symmetry	sta	pink op	银色对称	银对称	科目二	白银对称性
LOVE EAST	爱东	爱东方	转转
ないせんのうた	再见IM外星人	好他妈烦	这个地球是一秒都待不下去了
Streak	绿庙	米奇妙妙屋	拆房子
天狗の落とし文 feat. ｙｔｒ	天狗	犹太人	ytr
分からない	哇卡拉奶	我不知道	吾伐晓得	我不道啊	我不到啊
君の知らない物語	君の知らない物语	你不知道的故事	君知	君知物语
White Traveling Girl	白色旅行少女	白旅女	白色旅人
ロミオとシンデレラ	罗密欧	灰姑娘	罗密欧与辛德瑞拉	口三才
BATTLE NO.1	打架第一名	战地一	第一战	缝合怪	战第一
Prophesy One	预言一	p1
ECHO	回声	恶臭	一口
Caliburne ～Story of the Legendary sword～	生煎1	圣剑1	咖喱棒
only my railgun	炮姐	超炮
The wheel to the right	印度人	电锯	三块钱
Ultranova	A4纸	摩托车	超新星
Alea jacta est!	黑人打架	白人打架	孤注一掷	黑人击剑	尼哥	种植园纠纷	科比肘击詹姆斯
ねぇ、壊れタ人形ハ何処へ棄テらレるノ？	ねぇ、坏れタ人形ハ何处へ弃テらレるノ？	坏人偶	坏人形	坏人偶何处弃
魔ジョ狩リ	魔女狩猎	魔狩
花と、雪と、ドラムンベース。	花一轮	花雪	有好姐妹一起出勤吗
Lividi	李伟迪	李维迪
PANDORA PARADOXXX	潘多拉	PP	儿歌	白潘
SILENT BLUE	静蓝	SB	四块钱
TiamaT:F minor	提亚马特	音响龙	剃阿妈头发	m T:F	🦍🦍
FREEDOM DiVE (tpz Overcute Remix)	FD	自由落体	FDFD
Destr0yer	d0	削除光线	destroyer
7thSense	七拍子	第七感
夜明けまであと３秒	夜明3秒	夜明三秒	失明前三秒
Doll Judgment	人形裁判	DJ
高気圧ねこロック	高气压ねこロック	高气压猫猫头	高血压
トルコ行進曲 - オワタ＼(^o^)／	トルコ行进曲 - オワタ＼(^o^)／	土耳其进行曲
Crush On You	coy	COU	创死你
My Dearest Song	大提琴	生日歌	我爱歌
骸骨楽団とリリア	骸骨乐团とリリア	莉莉亚
In Chaos	阴超市	在超市
アポカリプスに反逆の焔を焚べろ	アポカリプスに反逆の焰を焚べろ	反逆焰
六兆年と一夜物語	六兆年と一夜物语	希腊奶
太陽系デスコ	太阳系デスコ	太阳系disco
oboro	小火球	小火苗
曖昧mind	暧昧mind	爱maimai
神室雪月花	雪月花	如龙
End Time	恩德太	嗯了么	et
キミノヨゾラ哨戒班	烧鸡班	哨戒班
ナンセンス文学	无意义文学	拍手文学
B.B.K.K.B.K.K.	bbkkbkk	Bass kick
シャルル	夏露露	三力儿儿	charles
タカハせ！名人マン	高桥名人	光头16连
私の中の幻想的世界観及びその顕現を想起させたある現実での出来事に関する一考察	私の中の幻想的世界观及びその显现を想起させたある现实での出来事に关する一考察	名字太长的歌	私中幻想的世界观	名字很长的歌
幻想のサテライト	幻想卫星
檄！帝国華撃団(改)	檄！帝国华击团(改)	滑稽团
立川浄穢捕物帳	立川净秽捕物帐	青岛侦探事务所
System “Z”	系统z	蔬菜沙拉
Glorious Crown	皇冠	王冠
脳漿炸裂ガール	脑浆炸裂ガール	脑浆炸裂女孩
患部で止まってすぐ溶ける～狂気の優曇華院	患部で止まってすぐ溶ける～狂气の优昙华院	患部止	优云华院	马应龙
Got more raves？	郭沫若	gmr
AMAZING MIGHTYYYY!!!!	AM
LANCE	蓝枪	兰斯	男厕
Outlaw's Lullaby	如龙2	OL	如龙1
Moon of Noon	月儿子	午月	尊尼获加
極圏	极圈	鸡圈
Credits	信用	cooperation	学分
B.M.S.	bms	光吉
Mr. Wonderland	王大狼	梦幻岛	王大郎
人里に下ったアタイがいつの間にか社畜になっていた件	人里に下ったアタイがいつの间にか社畜になっていた件	NO NO working
Beat of getting entangled	boge	胡来的处男	胡辣汤	纠缠的节拍
明星ロケット	明星火箭	明星银河号
ウサテイ	兔子快跑	帝帝跑跑跑
Rodeo Machine	广播	绿皮星星歌	马	绿手
ダンシング☆サムライ	茄子先生	跳舞武士
Help me, あーりん！	教我，永琳！	erin！erin！
アンハッピーリフレイン	unhappy refrain	不高兴的副歌
L9	绿9	轴交互
セガサターン起動音[H.][Remix]	セガサターン起动音[H.][Remix]	启动音	世嘉土星启动音
Endless World	无尽世界	ew
いっしそう電☆舞舞神拳！	いっしそう电☆舞舞神拳！	114514
Now or Never	现在或从不	non
カゲロウデイズ	车祸歌	车祸曲	阳炎眩乱
Reach For The Stars	追星	索3
BREAK YOU!!	破坏你	绝赞你
Secret Sleuth	ss	秘密侦探	兔爷快乐歌
最終鬼畜妹フランドール・S	最终鬼畜妹フランドール・S	蓝蓝路
Money Money	骂你骂你	钱钱	紫苑镇
We Gonna Party	wgp	咱想开派对
超常マイマイン	超常maimai
We Gonna Journey	我们要旅行	wgj
WARNING×WARNING×WARNING	注意注意注意	条纹过膝袜	星条旗
夢花火	梦花火	乙姬角色歌
Rooftop Run: Act1	逃离屋顶	索2
Monochrome Rainbow	单色彩虹	黑白彩虹
うまるん体操	小埋体操
名探偵連続殺人事件	名探侦联续杀人事件	名侦探	名侦探连续杀人事件
バラライカ	亚拉那一卡	空手道
quiet room	静屋	qr
ダンスロボットダンス	跳舞机器人	drd	Dance Robot Dance	舞动机器人之舞
Jumble Rumble	DJ鼠	几把乱爆	几把乱报
不思議の国のクリスマス	不思议の国のクリスマス	不可思议
クレイジークレイジーダンサーズ	ccd	疯狂疯狂跳舞	crazycrazydance	crazy crazy dance
パーフェクト生命	完美生命
進捗どうですか？	进捗どうですか？	进步	进度
進め！イッスン軍団 -Rebellion of the Dwarfs-	进め！イッスン军团 -Rebellion of the Dwarfs-	前进军团	小人国	小小兵团
真・ハンサム体操でズンドコホイ	帅哥体操	真体操	super面筋人	学园帅哥	五个小人发癫
少女幻葬戦慄曲 ～ Necro Fantasia	少女幻葬战栗曲 ～ Necro Fantasia	死灵幻想曲
いーあるふぁんくらぶ	王力宏	12fan
Sun Dance	阳舞	太阳舞	日跳舞	日舞
NIGHT OF FIRE	夜火	逮虾户
METATRON	梅塔特隆	钟楼
FEEL ALIVE	感觉活着	女人赛跑
夏祭り	夏祭	Our Wrenally
ポップミュージックは僕のもの	ポップミュージックは仆のもの	男童歌	男同	popmusic
Dreampainter	梦境绘画者	sta金曲
管弦楽組曲 第3番 ニ長調「第2曲（G線上のアリア）」BWV.1068-2	管弦乐组曲 第3番 ニ长调「第2曲（G线上のアリア）」BWV.1068-2	g弦
♡マイマイマイラブ♡	my my my love	sega游戏宇宙一	又人又人
チルノのパーフェクトさんすう教室	算数教室	琪露诺的完美算数教室	⑨
Last Brave ～ Go to zero	变成0	走向0	最后的勇气波浪线变成零
GET!! 夢&DREAM	GET!! 梦&DREAM	取得梦和梦	学园handsome
敗北の少年	败北の少年	败北少年	败北的少年
Acceleration	加速	转圈金曲
Burning Hearts ～炎のANGEL～	BR	阳炎
Beat Of Mind	bom	nmb的mai
シュガーソングとビターステップ	糖歌	糖车
一か罰	一か罚	一力罚	一刀罚
二息歩行	二息步行	儿媳不行
Seyana. ～何でも言うことを聞いてくれるアカネチャン～	Seyana. ～何でも言うことを闻いてくれるアカネチャン～	说的事呢
ぐるぐるWASH！コインランドリー・ディスコ	洗衣房	suomi
星屑ユートピア	星屑乌托邦
Change Our MIRAI！	五对柰子	改变未来	com	五对奶子
DO RORO DERODERO ON DO RORO	多罗罗	源平2	迪罗迪罗	百鬼大战绘卷
フラジール	fragile	易碎品
Dragoon	龙	龙骑士	鸭头
しゅわスパ大作戦☆	しゅわスパ大作战☆	修哇	修哇大作战	温泉大作战
物凄い勢いでけーねが物凄いうた	物凄い势いでけーねが物凄いうた	慧音
厨病激発ボーイ	厨病激发ボーイ	厨病激发男孩
FestivaLight	节日光	milked
色は匂へど散りぬるを	色散	伊洛瓦
LOSER	卢瑟	输了	我
L4TS:2018 (feat. あひる & KTA	银发女孩	伊蕾娜
CYCLES	马瓦鲁	马挖路	轮回
天ノ弱	天之弱	天弱
アマノジャクリバース feat. ｙｔｒ	天邪鬼反转	灵梦过马路	ytr
Danza zandA	小号歌	蛋砸砸蛋
KING is BACK!!	王者归来	kib
お気に召すまま	お气に召すまま	皆大欢喜	气召
ココロスキャンのうた	心灵扫描歌	捂裆男
magician's operation	魔法师手术	魔术手
共感覚おばけ	共感觉おばけ	共感怪兽
FLOWER	扶老二	花
SHINY DAYS	摇曳露营	虾泥爹
キズナの物語	キズナの物语	锁链战记	羁绊物语
Limit Break	LB	限制绝赞
四月の雨	四月的雨	四月雨
TEmPTaTiON	小萝莉	诱惑	小萝莉的诱惑	他不太深
Windy Hill -Zone 1	索4
ロストワンの号哭	号哭	lost one的号哭	失去1的号哭
Nyan Cat EX	彩虹猫
Ignis Danse	火神
ジングルベル	圣诞歌	圣诞节	jingle bell
DADDY MULK -Groove remix-	爸爸奶
Space Harrier Main Theme [Reborn]	太空哈利
the EmpErroR	皇帝	电磁脉冲错误
Bad Apple!! feat nomico	坏苹果
DRAGONLADY	龙女士
裏表ラバーズ	里表ラバーズ
Brain Power	脑力	O-oooooooooo
SPICY SWINGY STYLE	SSS
Pixel Voyage	小飞机
Like the Wind [Reborn]	一块钱
Ievan Polkka	甩葱歌
ネ！コ！	neko
L'épilogue	法文歌
ナイト・オブ・ナイツ	夜骑
GEMINI -M-	双子星	戈米尼
魔理沙は大変なものを盗んでいきました	魔理沙は大变なものを盗んでいきました	魔理沙偷走了重要的东西	魔理沙大便	魔理沙大变
HERA	赫拉	黑拉
緋色のDance	绯色のDance
玩具狂奏曲 -終焉-	玩具狂奏曲 -终焉-
Mysterious Destiny	贝姐	神秘命运
電車で電車でOPA!OPA!OPA! -GMT mashup-	电车で电车でOPA!OPA!OPA! -GMT mashup-	星星电车
Death Scythe	死镰
ウッーウッーウマウマ(ﾟ∀ﾟ)	扭腰歌
日本の米は世界一	日本米
エンドマークに希望と涙を添えて	エンドマークに希望と泪を添えて	希望泪	希望累	在终止符处添上希望与眼泪
このピアノでお前を8759632145回ぶん殴る	钢琴	1145141919810
Natural Flow	自然流
Halcyon	翡翠鸡
larva	拉瓦	幼虫	腊八
Believe the Rainbow	相信彩虹
奏者はただ背中と提琴で語るのみ	奏者はただ背中と提琴で语るのみ
Imperishable Night 2006 (2016 Refine)	2006
デビル☆アイドル	恶魔偶像
Axeria	ax
Blew Moon	吹月
LUCIA	露西亚
ネコ日和。	猫日和	猫天气
インビジブル	Invisible	透明人间
Fragrance	香水	斜塔	大楼
Back 2 Back	b2b	回二回
conflict	公交车	冲突	bus
VERTeX	水神
言ノ葉遊戯	言ノ叶游戏	言叶游戏
にじよめちゃん体操第一億	にじよめちゃん体操第一亿	体操一亿	1e8
月に叢雲華に風	月に丛云华に风	月丛云	月风	月映丛云花语风
猫祭り	猫祭
Scream out! -maimai SONIC WASHER Edit-	赞不绝口	美国紫妈
林檎華憐歌	林檎华怜歌	大妈唱歌	拜拜，拜拜
雷切-RAIKIRI-	雷切
TwisteD! XD	xd
初音ミクの消失	消失
Nitrous Fury	氮化福瑞
BOKUTO	波裤头	剥裤头
air's gravity	空气重力
Sakura Fubuki	樱吹雪	樱吹屎
ナイト・オブ・ナイツ (Cranky Remix)	夜骑2	dx夜骑	cranky也要当夜骑
炭★坑★節	炭★坑★节	炭坑节	碳坑节
Altale	机器人钓鱼	阿泰尔
天火明命	天火
猛進ソリストライフ！	猛进ソリストライフ！
Panopticon	监狱	中央美术学院
Scars of FAUNA	土神
Black Out	黑出
からくりピエロ	活动小丑	🤡
ガラテアの螺旋	螺旋
Scarlet Lance	红枪	狗含剑
Calamity Fortune	cf	卡拉米提佛纯	穿越火线
Revive The Rave	rtr
天国と地獄	天国と地狱	天国地狱
FUJIN Rumble	风神	福晋软贝	父进入母b了	父进入母逼
初音ミクの激唱	初音未来的激唱	机场
CITRUS MONSTER	橘子怪兽	CM
閃鋼のブリューナク	闪钢のブリューナク
Nerverakes	两块钱	地球仪
Lionheart	狮心
電車で電車でGO!GO!GO!GC! -GMT remix-	电车で电车でGO!GO!GO!GC! -GMT remix-
Jack-the-Ripper◆	开膛手杰克
Technicians High	科技高	高科技
隠然	隐然	引燃
リッジでリッジでGO!GO!GO! -GMT mashup-	电车gogogo
After Burner	冲破火网	AB
Feel My Fire	感受我的火
ピーマンたべたら	青椒	鼠鼠
デッドレッドガールズ	死红女	dead red girls
shake it!	摇它	爷爷爷爷
ヘルシーエンド	maimai你摸
グリーンライツ・セレナーデ	绿光小夜曲
DETARAME ROCK&ROLL THEORY	detarame
Crazy Circle	疯圈	黑喂狗
awake	醒了	起了
ドクハク	独白	棺材
サヨナラチェーンソー	再见电锯
全人類ノ非想天則	全人类ノ非想天则	全人类非想天則	绯想天	全人类的非想天则
咲キ誇レ常世ノ華	咲キ夸レ常世ノ华	常世华	常世之华
きみのためなら死ねる	为了你而死
come again	再来一遍
りばーぶ	reverb
ミラクル・ショッピング	购物
オパ! オパ! RACER -GMT mashup-	赛车
Brand-new Japanesque	全新日本人
Still	仍然
悪戯	恶戏
BETTER CHOICE	更好的选择
吉原ラメント	吉原哀歌
終わりなき物語	终わりなき物语	无尽物语	终物语
なるとなぎのパーフェクトロックンロール教室	琪露诺的完美算数教室	⑨
イロトリドリのメロディ	彩绿之歌
火炎地獄	火炎地狱
Kinda Way	KW
Catch The Future	抓住未来
シアワセうさぎ	幸福兔
End of Twilight	暮光终结
METEOR	流星
City Escape: Act1	索1
ドーナツホール	甜甜圈洞
keep hopping	kamome sano
ルカルカ★ナイトフィーバー	luka	儿力儿力
炎歌 -ほむらうた-	炎歌	凤凰传奇
新宝島	新宝岛
アルカリレットウセイ	碱性劣等生	莉莉卡
BLACK ROSE	黑玫瑰
Garden Of The Dragon	龙花园
ロールプレイングゲーム	rpg	火箭筒
メルト	melt
バッド・ダンス・ホール	坏舞厅	bdh
やめろ！聴くな！	やめろ！听くな！	别听
だからパンを焼いたんだ	だからパンを烧いたんだ	烧面包
響縁	响缘	响缘不是响绿
幾四音-Ixion-	几四音-Ixion-
怪盗Rのテーマ	怪盗R的影之诗
最速最高シャッターガール	最速最高	文文
Club Ibuki in Break All	绝赞俱乐部	西瓜跳舞
FEEL the BEATS	感受节拍	FB	ftb
キレキャリオン	carry on	切吧 Carry On	双挽乃保
おねがいダーリン	拜托了darling
Save This World νMIX	拯救世界
I ♥	我爱
源平大戦絵巻テーマソング	源平大战绘卷テーマソング	原批大战罕见
Live & Learn	SA2
フラグメンツ -T.V. maimai edit-	fragments
Imitation:Loud Lounge	奇面族	假面	呀哈哈	土著
Signature	签名卡
KISS CANDY FLAVOR	小红帽	亲亲砍弟佐料
Endless, Sleepless Night	无尽不眠夜
放課後ストライド	放课后ストライド	放课后冲
デコボコ体操第二	体操第二
鼓動	鼓动
東京リアルワールド	东京リアルワールド
橙の幻想郷音頭	橙の幻想乡音头	橙的幻想乡音头
セツナトリップ	刹那旅行	刹那旅程
教えて!! 魔法のLyric	教教
JACKY [Remix]	jacky
恋愛裁判	恋爱裁判
洗脳	洗脑
ローリンガール	滚女	rolling girl	翻滚少女
CocktaiL	鸡尾酒
sweet little sister	甜小姐姐	甜二妹
Night Fly	发热金曲	夜飞
マトリョシカ	俄罗斯套娃
白ゆき	白雪
彗星ハネムーン	彗星蜜月
Sprintrances	冰山
Life Feels Good	生活感觉好	好日子	感觉很好
デンパラダイム	电波
オモイヨシノ	恋咏樱
Invitation	邀请
Heartbeats	小红金曲
taboo tears you up	三倍icecream	淘宝撕碎你
チュルリラ・チュルリラ・ダッダッダ！	啾噜哩啦	哒哒哒	啾噜哩啦·啾噜哩啦·哒哒哒！
みくみくにしてあげる♪【してやんよ】	把你mikumiku掉
Party 4U ”holy nite mix”	p4u
P-qoq	灯射来红	拉面火箭
アディショナルメモリー	额外记忆
Turn around	转弯
儚きもの人間	儚きもの人间	梦人间	少女炼狱
GO BACK 2 YOUR RAVE	gb2	回去你的2rave	回去你的波	gb2yr	g2r
フリィダム ロリィタ	自由洛丽塔	嘘嘘
妖精村の月誕祭 ～Lunate Elf	妖精村の月诞祭 ～Lunate Elf
サンバランド	桑巴
ULTRA B+K	bk2	access to the light
スイートマジック	甜甜魔法	甜蜜魔法	sweet magic
怒槌	怒锤	怒捶	Ikazuchi
はやくそれになりたい！	我想快点成为它！	好想快点变成那样	搞快点
夜咄ディセイブ	夜咄	kano角色歌
メランコリック	忧郁的心情
頓珍漢の宴	顿珍汉の宴	盾震撼
美しく燃える森	美燃森
JUMPIN' JUMPIN'	SH金曲	姜萍
イノコリ先生	先生	留堂老师
イカサマライフゲイム	作弊生存游戏
Starlight Vision	星光视觉
みんなの	兽道	大家的
Love You	爱你
光線チューニング	光线チューニング	光线turning
Hyper Active	黄卡车	小黄车	泥头车
空威張りビヘイビア	空威张りビヘイビア
Bang Babang Bang!!!	邦邦邦	邦邦邦邦	太大了我都看晕了
YATTA!	好耶！
華鳥風月	华鸟风月	花鸟风月
Link	林克
BAD∞END∞NIGHT	坏结夜	BAD END NIGHT
ぴぴぱぷぅ！	比巴卜
ワールズエンド・ダンスホール	末世舞厅	世末舞厅
もうみんなしねばいいのに	大家死了好	骂脏话
KONNANじゃないっ！	柯南
幾望の月	几望の月	几望之月	几望的月
アウトサイダー	outsider
その群青が愛しかったようだった	その群青が爱しかったようだった	群青爱
Help me, ERINNNNNN!!	erin	永琳
デスパレイト	desperate
ジンギスカン	成吉思汗
オトヒメモリー☆ウタゲーション	乙姫	乙姬
Cosmic Train	宇宙列车
Starlight Disco	星光迪斯科
メルティランドナイトメア	melty land nightmare	梦魇	mln	春卷饭
バーチャルダム　ネーション	赛车	virtualdam nation	虚拟赛车
究極焼肉レストラン！お燐の地獄亭！	究极烧肉レストラン！お燐の地狱亭！
【東方ニコカラ】秘神マターラ feat.魂音泉【IOSYS】	【东方ニコカラ】秘神マターラ feat.魂音泉【IOSYS】	见前
無敵We are one!!	无敌We are one!!	我们是1	我们是无敌1	无敌我们是一	无敌我们是1
Justified	正义	森林冰火人
疾走あんさんぶる	疾走
若い力 -SEGA HARD GIRLS MIX-	若力
ストリーミングハート	流心
Infantoon Fantasy	if
Selector	选择器
言ノ葉カルマ	言ノ叶カルマ	言叶业
リンカーネイション	轮回转生
TRUST	足控	小仏凪色图	玉足
キリキリ舞Mine	girigiri舞
ネトゲ廃人シュプレヒコール	ネトゲ废人シュプレヒコール	网游废人
ソーラン☆節	ソーラン☆节	索兰节
でらっくmaimai♪てんてこまい!	滴蜡熊
スリップフリップ	slipflip	大脸妹	短发妹
HOT LIMIT	热限	阳性
ゴーゴー幽霊船	ゴーゴー幽灵船
エピクロスの虹はもう見えない	エピクロスの虹はもう见えない	圣母	虹见
モザイクロール	马赛克卷	绿毛
ぽっぴっぽー	蔬菜歌	蔬菜汁
Yakumo >>JOINT STRUGGLE (2019 Update)	八云紫	yakumo
Yet Another ”drizzly rain”	帕秋莉
True Love Song	真爱歌
妄想感傷代償連盟	妄想感伤代偿联盟	盲肠肝脏大肠年龄
蒼空に舞え、墨染の桜	苍空に舞え、墨染の樱	墨染樱
永遠のメロディ	永远のメロディ	永远的melody
待チ人ハ来ズ。	待人未至	待人来
ケロ⑨destiny	⑨	9
ラブリー☆えんじぇる!!	可爱天使
Barbed Eye	狗谷爱	坏眼
キャプテン・ムラサのケツアンカー	船长
MYTHOS	小提琴
ひれ伏せ愚民どもっ！	愚民	伏愚民
虹と太陽	虹と太阳	虹太阳	彩虹与太阳
Starlight Dance Floor	发热错位金曲	星光舞厅
ナミダと流星	眼泪与流星	眼泪流星
YA･DA･YO [Reborn]	亚达哟	YADAYO
フィクサー	fixer	修人
サドマミホリック	灵梦撒币	sb
StargazeR	观星者
しねばいいのに	死了一了百了
ゴーストルール	幽灵法则	Ghost rule	狗斯特露露
39みゅーじっく！	39music	大大大大大大傻逼
相思創愛	相思创爱
WORLD'S END UMBRELLA	世末伞
だれかの心臓になれたなら	だれかの心脏になれたなら	如果能成为谁的心脏的话
パンダヒーロー	panda hero
福宿音屋魂音泉	魂音泉
幽闇に目醒めしは	幽暗に目醒めしは	幽目
泡沫、哀のまほろば	泡沫
Xevel	黑白双gay	x
maiム・maiム feat.週刊少年マガジン	maiム・maiム feat.周刊少年マガジン
魔法少女になるしかねぇ	魔法少女
アウターサイエンス	界外科学
Jimang Shot	急忙射
記憶、記録	记忆、记录	记忆记录	恐怖谷
Spin me harder	蓝蝴蝶	电蝴蝶
立ち入り禁止	立入禁止	禁止进入
終点	终点
すーぱーぬこになりたい	变超猫	nuko
Get Happy	爽了	给爽
Future	未来	错位歌
ハロ／ハワユ	Hello，how are you	你好你吃了吗	hay
泣き虫O'clock	泣虫	爱哭鬼
円舞曲、君に	圆舞曲、君に
エイリアンエイリアン	外星人	alien
時空を超えて久しぶり！	时空を超えて久しぶり！	puyopuyo
レッツゴー!陰陽師	レッツゴー!阴阳师
Cosmic Magic Shooter	宇宙魔术射手
腐れ外道とチョコレゐト	外道	巧克力	腐外道
planet dancer	星球舞者	爸爸拉粑粑
ARROW	箭
東方妖々夢 ～the maximum moving about～	东方妖々梦 ～the maximum moving about～	妖妖梦	东方不可拘束
Scarlet Wings	猩红之翼	小星星2	REDALiCE	红翅膀子	红烧鸡翅
アンノウン・マザーグース	妈妈鹅	鹅妈妈
REVIVER オルタンシア・サーガ -蒼の騎士団- オリジナルVer.	REVIVER オルタンシア・サーガ -苍の骑士团- オリジナルVer.	苍之骑士团
バレリーコ	芭蕾舞者
アマツキツネ	天狐
不毛！	不毛
ワンダーラスト	wander last	wanderlast	luka
EVERGREEN	常绿	一直绿	青春永驻
命ばっかり	全是命	命没	只为生命
みんなのマイマイマー	大家的maimai吗
ユビキリ	拉勾勾
U.S.A.	usa
おても☆Yan	阿铁摸呀	陕北民歌	阿铁摸鸭	山歌
天国と地獄 -言ノ葉リンネ-	天国と地狱 -言ノ叶リンネ-	天国地狱
ジャガーノート	juggernaut
四次元跳躍機関	四次元跳跃机关
囲い無き世は一期の月影	围い无き世は一期の月影
Sky High [Reborn]	天空高
MilK	牛奶
あねぺったん	只含月铃姐妹
きらっせ☆ウッド村ファーム	妖精村
神々の祈り	神祈
Her Dream Is To Be A Fantastic Sorceress	她的梦想是成为一名了不起的女巫
アカリがやってきたぞっ	赤里来了	阿卡丽
Session High⤴	⤴️	⬆️	↗️
イアイア★ナイトオブデザイア	七对奶子
フォルテシモBELL	Fortissimo BELL
ナイトメア☆パーティーナイト	噩梦☆派对之夜
INFINITE WORLD	英菲尼迪
ラブチーノ	lovecino
fake!fake!	假假
超絶！Superlative	超绝！Superlative
心象蜃気楼	心象蜃气楼	心象晨气楼
Let's Go Away	恶臭赛车
セハガガガンバッちゃう！！	世嘉硬件女孩
エテルニタス・ルドロジー	～AETERNITAS LUDOLOGY～	东方鼓动
YU-MU	榆木脑袋
オーディエンスを沸かす程度の能力 feat.タイツォン	沸腾程度	东方月灯笼
どうしてこうなった	为什么会这样	怎会如此	跳舞狗
connecting with you	pink挑战
メグメグ☆ファイアーエンドレスナイト	megumegu☆fire endless night
願いを呼ぶ季節	愿いを呼ぶ季节
犬日和。	狗日子	狗天气
RIDGE RACER STEPS -GMT remix-	我创死你
Tic Tac DREAMIN’	⏰	大雷
maimaiちゃんのテーマ	maimai酱
Tell Your World	TYW
コトバ・カラフル	kotoba colorful	女同3
true my heart -Lovable mix-	真我心	女人打电话
ハート・ビート	heart·beat
Jump!! Jump!! Jump!!	三蹦子	跳跳跳
宿題が終わらないっ！	宿题が终わらないっ！	触手调教
ありふれたせかいせいふく	司空见惯的世界征服
赤心性：カマトト荒療治	赤心性：カマトト荒疗治
M.S.S.Planet	妈杀杀星球	mss
SPILL OVER COLORS	小脸妹	小画家
馬と鹿	马と鹿	马和鹿	笨和蛋
ラブ・ドラマティック feat. 伊原六花	Love Dramatic	哦辣妹迷死他哦迷死他
アンドロイドガール	Android Girl	机器女孩	安卓女孩
スロウダウナー	Slow downer
ビターチョコデコレーション	苦巧克力
スターリースカイ☆パレード	Starry Sky☆Parade
ヤミツキ	痴迷
Valsqotch	金熊	黄金滴蜡熊
モ°ルモ°ル	毛儿毛儿
絡めトリック利己ライザー	络めトリック利己ライザー
ソリッド	大贫民
Bad Apple!! Feat.nomico (REDALiCE Remix)	坏苹果remix
宛城、炎上！！	炎上	宛城炎上
Jörqer	jorqer
だから僕は音楽を辞めた	だから仆は音乐を辞めた	我放弃了音乐	所以我放弃了音乐	不要停下来啊	所以我放弃音乐了
"Sqlupp (Camellia's ""Sqleipd*Hiytex"" Remix)"	色情撸屁屁	失去了屁屁
渦状銀河のシンフォニエッタ	涡状银河のシンフォニエッタ	抽水马桶
GRÄNDIR	grandir
BaBan!! －甘い罠－	甜蜜的陷阱
Backyun! －悪い女－	Backyun! －恶い女－	恶女	坏女人
D✪N’T  ST✪P  R✪CKIN’	don't stop rocking	dont stop rocking	dsr
おこちゃま戦争	おこちゃま战争	孩子们的战争	孩子气战争	孩子气的战争
Link(CoF)	链接
+♂	嘉然	加男
STAIRWAY TO GENERATION	阶梯
拝啓ドッペルゲンガー	拜启ドッペルゲンガー	亲爱的分身	敬启我的分身
ネクロファンタジア～Arr.Demetori	Necro Fantasia
CHOCOLATE BOMB!!!!	巧克力炸弹
Bad Apple!! feat.nomico (REDALiCE Remix)	坏苹果
STEEL TRANSONIC	钢铁超音速
Flashkick	闪踢	快闪
Stardust Memories	星尘回忆
My My My	我我我	mymymy
ブレインジャックシンドローム	利香
共鳴	共鸣
Ututu	乌图图	乌班图	ubuntu
シエルブルーマルシェ	蓝色市场	Ciel Bleu Marche
封焔の135秒	封焰の135秒	封焰135	封焰幺三五
ワードワードワード	词词词	word word word
最強 the サマータイム!!!!!	最强 the サマータイム!!!!!
タテマエと本心の大乱闘	タテマエと本心の大乱斗
はちみつアドベンチャー	蜜蜂冒险	蜂蜜冒险
popcorn	爆米花
ハム太郎とっとこうた	哈姆太郎
青空のラプソディ	蓝天的狂想曲
クレイジー・ビート	疯狂节拍	Crazy beat
バイオレンストリガー	暴力触发	暴力扳机	暴力拆机
グラーヴェ	坟
KILLER B	杀手乙	杀手b	杀B	傻逼
すーぱーぬこになれんかった	我无法成为超级努子	魔法美发滚
深海シティアンダーグラウンド	深海城市地下
表裏一体	表里一体	硬币两面
Catch the Wave	赶上潮流
Witches night	女巫之夜	古明地恋	古明地三鲜
Drive Your Fire	开火	开你的火
wheel	车轮	轮子
energy trixxx	能量三角
NULCTRL	空键
アトロポスと最果の探究者	阿特罗波斯和终极探索者	最果探究者
Lunar Mare	月马
Saika	彩华
CHAOS	超市	超死	混沌
Maboroshi	幻影
ウマイネームイズうまみちゃん	Umai 的名字是 Umami-chan	哆啦A梦
ぼくたちいつでも　しゅわっしゅわ！	我们总是洗牌！	咻哇咻哇	修哇
居並ぶ穀物と溜息まじりの運送屋	居并ぶ谷物と溜息まじりの运送屋	谷物运送屋	老汉推车	木雕二	木雕2	老汉拉车
ノーポイッ!	没有点！	点兔
町かどタンジェント	城镇角切线
紅蓮華	红莲华
命に嫌われている	命嫌	被生活讨厌	嫌命长
アンクローズ・ヒューマン	未封闭的人类	unclose human
乙女解剖	处女解剖
悪戯センセーション	恶戏センセーション	调皮的感觉
Paranoia	偏执狂
Pretender	伪装者
Beautiful Future	美丽未来
Mutation	木糖醇
レーイレーイ	ray ray	rayray
絶え間なく藍色	绝え间なく蓝色	绝间蓝色
ガランド	花环	Airhead	garando
とりあえずアナタがいなくなるまえに	总是在你消逝之前
明星ギャラクティカ	明星银河号
絶対にチョコミントを食べるアオイチャン	绝对にチョコミントを食べるアオイチャン	绝对要吃巧克力薄荷的葵酱	绝对要吃巧克力薄荷冰激淋的葵酱	绝对要吃巧克力薄荷冰淇淋的葵酱	琴叶葵
デリヘル呼んだら君が来た	呼君来
ベノム	猛毒	venom
"≠彡""/了→"	删了	太空熊	彡了
Climax	妖艳魔男	高潮	stop in maimai
c.s.q.n.	csqn	厕所青年	吃屎去捏	吃屎青年
YURUSHITE	原谅我	狗屎	五河琴里	玉如屎	王妃
カラッポ・ノンフィクション	Carappo Nonfiction
emomomo	😅	🤔
ユメヒバナ	梦火花	梦7810	梦七八十
Arty Party	USAO Party	纵连派对	纵派	U趴
パラボラ	抛物线	体育生
アスノヨゾラ哨戒班	哨戒班
Grievous Lady	病女	对立拉窗帘	gl
Cyaegha	绿魔王	完形填空
Ether Strike	es	以太冲击
ワンダーシャッフェンの法則	ワンダーシャッフェンの法则	萝莉法则	创造奇迹的法则
BREaK! BREaK! BREaK!	bbb	绝赞绝赞绝赞	爆爆爆	卧槽全大P
物凄いヴァイブスで魔理沙が物凄いラップ	魔理沙物凄
絡繰りドール	络缲りドール
ポケットからぬりつぶせ！	把它从你的口袋里掏出来！
Desperado Waltz	绝望的华尔兹
シアトリカル・ケース	theatrical case	黑玫瑰3	戏剧性事件	戏剧性案件
BIRTH	出生	畜生	初生
Sound Chimera	声音奇美拉
雨とペトラ	雨与佩特拉
ロストワードクロニカル	东方归言录编年史	Lost word chronical
Xenovcipher	泽拉斯
ネガティブ進化論	ネガティブ进化论	negative进化论	负进化论	消极进化论	逊
永遠にゲームで対戦したいキリタン	永远にゲームで对战したいキリタン	永远都想对战游戏的切蒲英	永远对战	想永远玩游戏的Kiritan	东北切蒲英
Heavenly Blast	天爆	皇冠2	😆
おジャ魔女カーニバル!!	奥哈女巫嘉年华	小魔女	光吉猛修跳舞	光吉猛修发癫
時計の国のジェミニ	时计の国のジェミニ	钟表国度的双子座	时计之国	时计国
秒針を噛む	秒针を啮む	咬住秒针
タケモトピアノCMソング	竹本钢琴CM歌	钢琴广告
もぺもぺ	mopemope	毛八毛八
Paradisoda	天堂苏打
ハジマリノピアノ	羽岛里诺钢琴	yyut
冬のこもりうた	冬天低沉的歌	冬之摇篮曲
Virtual to LIVE	vtl	皮套人之歌	雨刮器	彩虹社
VANTABLACK RAVER	电乙姬	黑乙姬
届かない花束	届不到	未送达的花束	届花束
単一指向性オーバーブルーム	单一指向性オーバーブルーム	单一指向性overbloom
サヨナラフリーウェイ	sayonara freeway	再见高速公路
ステップアンドライム	step and lime
スローアライズ	slow rise	slow arise
生命不詳	生命不详	二蚌	不知死活
Rush-More	冲更多	多冲
チエルカ／エソテリカ	宫下游	四个日本字杠五个日本字	千工儿力
CO5M1C R4ILR0AD	银河铁道	cosmic railroad	5140	星穹铁道
幽霊東京	幽灵东京
星めぐり、果ての君へ。	星果君	星斗流转，赴你为终
オリフィス	Orifice
オーケー？　オーライ！	Okay?  All right!
ベースラインやってる？笑	bassline	洽个V	妹妹恰个v
VIIIbit Explorer	8bit浏览器
ほしぞらスペクタクル	水母	水母姐
約束	约束	约定
グッバイ宣言	再见宣言	MEGATON KICK
Estahv	白戒
	无名	如月车站	空格	空白	没名字	N/A
僕の和風本当上手	仆の和风本当上手	我的和风真的很牛逼
otorii INNOVATED -[i]3-	大鸟居	雷熊	电所有人前列腺	电前列腺
猫猫的宇宙論	猫猫的宇宙论	猫猫宇宙论
Mjölnir	钢琴冒烟
廻廻奇譚	廻廻奇谭	咒术回战	回回奇谭
Good bye, Merry-Go-Round.	旋转木马	旋转杩
エンヴィーベイビー	envy baby	envy babe
アカツキアライヴァル	拂晓抵达
ヴァンパイア	吸血鬼
sølips	solips	嗦	100块钱	一百元	一百块钱	👦🏻
ヒトガタ	人型	匕卜力夕
GIGANTØMAKHIA	老头环	三体	走路人	费大
ラグトレイン	延误列车
失敗作少女	失败作少女
華の集落、秋のお届け	华の集落、秋のお届け	华落	华集
テリトリーバトル	领土战争	领地战争	小男娘	territory battle
Big Daddy	大爹	星野爱高潮
インドア系ならトラックメイカー	室内系
Lights of Muse	喵斯之光
ヨミビトシラズ	原批大战罕见	东雪莲	冬雪莲	咏人不详
First Dance	一！舞！
スピカの天秤	希望泪2
Princess♂	蜘蛛精	木桶饭
INTERNET OVERDOSE	妍酱
初音天地開闢神話	初音天地开辟神话	开天辟地	盘古	初音开天辟地神话
蒼穹舞楽	苍穹舞乐
ぱくぱく☆がーる	江江报菜名	肚子饿了	蔡明
パーフェクション	perfection
tape/stop/night	强虫
ツクヨミステップ	月读	月读舞步
エゴロック	ego rock	自我摇滚
チューリングの跡	チューリングの迹	图灵	萨克斯	图灵之迹
Love's Theme of BADASS ～バッド・アス 愛のテーマ～	Love's Theme of BADASS ～バッド・アス 爱のテーマ～	拔大蒜
くらべられっ子	被比较的孩子
アルティメットセンパイ	究极先辈
脳天直撃	脑天直击
宿星審判	宿星审判
スーパーシンメトリー	超对称性
U&iVERSE -銀河鸞翔-	U&iVERSE -银河鸾翔-	银河翱翔	金牛奶
BLACK SWAN	黑天鹅
僕は空気が嫁ない	仆は空气が嫁ない	我不要嫁给空气
Lia=Fail	圣剑3
Raven Emperor	锐雯皇帝
Southern Cross	南十字星	屏幕上有蟑螂
とびだせ！TO THE COSMIC!!	去宇宙
Shooting Stars	流星
どぅーまいべすと！	do my best	domybest
Regulus	热咕噜
ノイローゼ	神经病
テレキャスタービーボーイ	telecaster b-boy	tbb
Starry Colors	繁星色彩
泥の分際で私だけの大切を奪おうだなんて	泥の分际で私だけの大切を夺おうだなんて	区区污泥也想抢走我的至宝	泥分际大切夺	泥歌
前衛的Landscape	前卫的Landscape	亲爱滴小妹妹	给我玩舞萌DX
Falsum Atlantis.	亚特兰蒂斯
Round Round Spinning Around	跑跑卡丁车
ヒミツCULT	保安
MAKE IT FUNKY NOW	三明治
神々が恋した幻想郷	神々が恋した幻想乡	东十字星	众神眷恋的幻想乡	翠十字
KING	无名指扣牙
噛み係	啮み系	咬系	96猫	牙线	齿系
躯樹の墓守	躯树の墓守	欧内的守
リモコン	遥控器
うっせぇわ	吵死了
Armageddon	阿妈咯噔
8-EM	ATM
ハードコア・シンドローム	hardcore	打架第二名	哈的扣	梅西哥拆机
アンビバレンス	矛盾心理
ポッピンキャンディ☆フィーバー！	candy	糖果
Dreadnought	电棒子	手电筒
夜に駆ける	夜に驱ける	夜驱
ｉｓｏｐｈｏｔｅ	isophote
エータ・ベータ・イータ	工一夕	hera2	蓝原椿	纵连2	赫拉2	赫拉二
World's end loneliness	世终孤独
ヒステリックナイトガール	歇斯底里的深夜女孩
MOBILYS	灯球
春嵐	春岚	春日风暴
パラマウント☆ショータイム！！	魔法兔子	至高的表演时间	paramount show time
Last Samurai	最后的武士
folern	佛冷	乐山大佛盖小被
BLUE ZONE	蓝区	蓝的车
[X]	推特	x
フォニイ	phony	伪物
Don't Fight The Music	别打歌	不要打歌	别打音乐
ViRTUS	辣妹子辣	水神2	水神二
Metamorphosism	消除鬼叫	变态主义
SUPER AMBULANCE	超级救护车
Never Give Up!	永不放弃
コスモポップファンクラブ	宇宙星空俱乐部
Strive against fate	逆天改命
ジャンキーナイトタウンオーケストラ	玛奇玛	瘾者之城
デッドマンズバラッド	僵尸娘
ディカディズム	年代主义	decadism
ホシシズク	fes主题曲	星雫	三小只2
Rising on the horizon	在地平线升起
mystique as iris	神秘如鸢尾花	如鸢尾花般神秘
Hainuwele	华为	huawei
Rainbow Rush Story	彩虹冲故事
トラフィック・ジャム	traffic jam	交通堵塞	交通阻塞
HECATONCHEIR	百臂巨人
ピリオドサイン	休止符
マーシャル・マキシマイザー	马歇尔最大化器	核事故
秋の未確認生物	秋の未确认生物
ばかみたい【Taxi Driver Edition】	damedane
群青シグナル	群青信号	群青讯号
モンダイナイトリッパー！	没问题
エナドリおいしいソング	能量饮料	能量饮料好喝歌
Re：End of a Dream	终梦
Swift Swing	海澜之家
Aegleseeker	光追
"411Ψ892"	211985
N3V3R G3T OV3R	ngo	3333
星詠みとデスペラード	星咏みとデスペラード
きゅうくらりん	心跳不止
Beat Opera op.1	甘雨
Baddest	日本女子高中生大笑1分钟	哈里路大旋风
マツヨイナイトバグ	待宵的萤火虫	绿毛虫
"""411Ψ892"""	411892	985211	211985
enchanted love	el
Comet Panto Men!	特大跳舞
神っぽいな	像神一样呐	神poi
阿修羅ちゃん	阿修罗ちゃん
ロウワー	lower
春を告げる	春告	宣告春天
Tricolor⁂circuS	三色马戏团	三个出生
地上の戦士	地上の战士
東方スイーツ！～鬼畜姉妹と受難メイド～	东方スイーツ！～鬼畜姉妹と受难メイド～
Alice in 冷凍庫	Alice in 冷冻库
キラメキ居残り大戦争	キラメキ居残り大战争
今、誰が為のかがり火へ	今、谁が为のかがり火へ
紅星ミゼラブル～廃憶編	红星ミゼラブル～废忆编
悪魔の踊り方	恶魔の踊り方	恶魔的舞蹈方式
響け！CHIREI MY WAY!	响け！CHIREI MY WAY!
撩乱乙女†無双劇	撩乱乙女†无双剧
あの世行きのバスに乗ってさらば。	あの世行きのバスに乘ってさらば。
吾輩よ猫であれ	吾辈よ猫であれ
剣を抜け！GCCX MAX	剑を拔け！GCCX MAX
大輪の魂 (feat. AO, 司芭扶)	大轮の魂 (feat. AO, 司芭扶)
紅に染まる恋の花	红に染まる恋の花
終焉逃避行	终焉逃避行
遺伝子レベル∞スパイラル	遗传子レベル∞スパイラル
ただ選択があった	ただ选择があった
分解収束テイル	分解收束テイル
星見草	星见草
康莊大道	康庄大道
蜘蛛の糸	蜘蛛の丝	蜘蛛丝
電光石火	电光石火
残響散歌	残响散歌
スカーレット警察のゲットーパトロール24時	スカーレット警察のゲットーパトロール24时
銀のめぐり	银のめぐり
最強STRONGER	最强STRONGER
不機嫌なスリーカード	不机嫌なスリーカード
リスペク風神	リスペク风神
[協]Love You	[协]Love You
[協]ぽっぴっぽー	[协]ぽっぴっぽー
[協]恋愛裁判	[协]恋爱裁判
[協]Hand in Hand	[协]Hand in Hand
[協]疾走あんさんぶる	[协]疾走あんさんぶる
[協]ポップミュージックは僕のもの	[协]ポップミュージックは仆のもの
[協]ラグトレイン	[协]ラグトレイン
[協]アカツキアライヴァル	[协]アカツキアライヴァル
魔法少女とチョコレゐト	魔法少女与巧克力
NightTheater	夜剧场
おとせサンダー	落下雷霆
ツムギボシ	纺星
トリアージ	triage
ミルキースター・シューティングスター	Milky Star・Shooting Star
ヒバリ	匕八刂	两个羽毛球
Cthugha	火球
Final Step!	最后一步
#狂った民族２ PRAVARGYAZOOQA	狂民族2
Aetheric Energy	紫13大地雷
れっつ！みらくる☆はーどこあっ！	雌小鬼	老二老婆	laur老婆
三妖精SAY YA!!!	我们三
AMABIE	阿妈别
インターネットサバイバー	internet survivor
Komplexe	像神一样啊
コンティニュー！ feat. 藍月なくる	コンティニュー！ feat. 蓝月なくる	continue
＊ハロー、プラネット。	hello planet
OTOGEMA	电棍
キャットラビング	爱猫
VERTeX (rintaro soma deconstructed remix)	水神1.5	水神 1.5
Y.Y.Y.計画!!!!	Y.Y.Y.计画!!!!	yyy
にゃーにゃー冒険譚	にゃーにゃー冒险谭
宵の鳥	宵の鸟
隠密あんみつDX	隐密あんみつDX
超熊猫的周遊記（ワンダーパンダートラベラー）	超熊猫的周游记（ワンダーパンダートラベラー）
絶対敵対メチャキライヤー	绝对敌对メチャキライヤー
『ウソテイ』 ～一回戦せりなvsしろなvsなずな～	『ウソテイ』 ～一回战せりなvsしろなvsなずな～
Bad Apple!! feat.nomico ～五十嵐 撫子 Ver.～	Bad Apple!! feat.nomico ～五十岚 抚子 Ver.～
ずんだもんの朝食　〜目覚ましずんラップ〜	ずんだもんの朝食　〜目觉ましずんラップ〜
あなたは世界の終わりにずんだを食べるのだ	あなたは世界の终わりにずんだを食べるのだ
[蔵]Aegleseeker	[藏]Aegleseeker
